Levels
248
C#5:1---------------1---------------1---------------1------------------
 B4:-1---------------1---------------1---------------1-----------------
G#4:--1---------------1---------------1---------------1----------------
F#4:---1---------------1---------------1---------------1---------------
 E4:----1hh1111--1hh----1hh1111---------1hh1111--1hh----1hh1111--------
D#4:-----------11------------------------------11----------------------
C#4:---------------------------11------------------------------11------
 B3:-----------------------------1hh-----------------------------1hhhhh
