Levels
248
C#6:1---------------1---------------1---------------1------------------
 B5:-1---------------1---------------1---------------1-----------------
G#5:--1---------------1---------------1---------------1----------------
F#5:---1---------------1---------------1---------------1---------------
 E5:----1hh1111--1hh----1hh1111---------1hh1111--1hh----1hh1111--------
D#5:-----------11------------------------------11----------------------
C#5:1---------------1----------11---1---------------1----------11------
 B4:-1---------------1-----------1hh-1---------------1-----------1hhhhh
G#4:--1---------------1---------------1---------------1----------------
F#4:---1---------------1---------------1---------------1---------------
 E4:----1hh1111--1hh----1hh1111---------1hh1111--1hh----1hh1111--------
D#4:-----------11------------------------------11----------------------
C#4:---------------------------11------------------------------11------
 B3:-----------------------------1hh-----------------------------1hhhhh
